ID,MinionName,HP,Energy,ATK,Healing,Speed,Sum,Type 1,Type 2
96,Cerberus,65,45,90,35,75,310,DEMONIC,FIRE
79,Destrabell,45,45,65,45,45,245,HOLY,FIRE
80,Healabell,45,45,45,65,45,245,HOLY,FIRE
68,Egcrow,35,40,45,25,35,180,DEMONIC,FLYING
69,Skulcrow,40,55,60,35,65,255,DEMONIC,FLYING
70,Krobone,55,70,75,45,70,315,DEMONIC,FLYING
71,Leeru,15,35,45,35,50,180,DEMONIC,
72,Duleer,25,45,65,50,70,255,DEMONIC,
73,Leerpo,35,55,70,65,85,310,DEMONIC,
74,Banesha,45,65,60,40,55,265,UNDEAD,FIRE
82,Saintifi,60,50,75,75,60,320,HOLY,
81,Frostag,25,55,70,65,70,285,ICE,
75,Pumcin,35,45,35,30,35,180,DEMONIC,UNDEAD
76,Scaredrow,50,65,45,40,45,245,DEMONIC,UNDEAD
77,Scaredoom,65,75,70,50,55,315,DEMONIC,UNDEAD
78,Biomez,75,70,45,45,30,265,UNDEAD,
3,Zapig,30,45,40,10,40,165,FIRE,ENERGY
1,Ticub,40,45,40,35,50,210,NORMAL,
2,Tigertan,60,65,60,45,70,300,NORMAL,
97,Eeliforce,85,75,85,45,35,325,UNDEAD,WATER
51,Bab-8r,35,57,30,25,35,182,ROBOT,
52,Ant-8r,55,70,40,35,45,245,ROBOT,
53,Chidilla,65,45,30,7,15,162,ROBOT,
54,Armordilla,85,55,40,10,25,215,ROBOT,
48,Elecat,25,35,40,25,50,175,ENERGY,
49,Cheecha,30,40,50,30,70,220,ENERGY,
50,Lightina,35,45,65,35,95,275,ENERGY,
95,Domisteam,50,35,80,35,75,275,ROBOT,
55,Dogler,40,30,35,25,35,165,ENERGY,DEMONIC
56,Houndler,55,40,45,35,45,220,ENERGY,DEMONIC
57,Slime,40,55,25,25,30,175,NORMAL,
58,Gigaslime,60,70,35,35,35,235,NORMAL,
59,Destroslime,80,95,45,45,45,310,NORMAL,
60,Beakif,40,30,45,30,55,200,FLYING,ENERGY
61,Eaglin,65,40,65,45,75,290,FLYING,ENERGY
62,Amliflier,45,35,60,30,80,250,ROBOT,FLYING
63,Jellyjolt,10,35,65,40,45,195,WATER,ENERGY
64,Hydravolt,20,50,85,60,65,280,WATER,ENERGY
98,Megalatron,80,55,70,50,45,300,WATER,ROBOT
65,Shoktail,45,40,30,20,42,177,ENERGY,EARTH
66,Emperun,60,50,40,30,55,235,ENERGY,EARTH
67,Empawrath,75,60,60,40,65,300,ENERGY,EARTH
100,Dracolt,60,50,75,60,85,330,WATER,ENERGY
46,Harwing,25,40,60,60,75,260,DEMONIC,FLYING
47,Firox,35,40,60,60,70,265,FIRE,HOLY
93,Titoro,50,35,80,20,65,250,ROBOT,FIRE
41,Vudu,20,25,45,35,40,165,FIRE,
42,Hudu,40,35,55,45,65,240,FIRE,
94,Tortastone,100,25,15,20,5,165,EARTH,
23,Wafin,40,40,40,40,60,220,WATER,
24,Tatail,30,40,35,25,40,170,NORMAL,
25,Kleptoon,40,50,50,35,65,240,NORMAL,
86,Rexabee,35,25,38,5,20,123,DINO,
87,Tenasauras,60,30,65,10,35,200,DINO,
88,Rexathor,80,35,85,15,45,260,DINO,
26,Chirpla,5,25,40,25,45,140,FLYING,
27,Airmony,10,30,55,30,60,185,FLYING,WATER
28,Falcona,15,35,75,35,85,245,FLYING,WATER
29,Sealo,50,45,40,20,20,175,ICE,WATER
30,Sealast,75,60,55,30,30,250,ICE,WATER
31,Foramare,60,75,60,75,45,315,PLANT,WATER
16,Betehorn,37,30,45,20,30,162,EARTH,NORMAL
17,Betestone,50,35,60,25,40,210,EARTH,NORMAL
18,Betehulk,85,40,85,30,45,285,EARTH,NORMAL
9,Tremole,45,25,25,10,10,115,EARTH,
10,Seizemole,75,30,30,12,15,162,EARTH,
11,Sumole,90,35,40,15,20,200,EARTH,
92,Holymantis,30,50,25,87,60,252,PLANT,HOLY
21,Shrumpy,40,35,40,25,30,170,PLANT,ICE
22,Eldrest,65,50,55,35,35,240,PLANT,ICE
19,Archick,20,35,30,35,45,165,FLYING,ICE
20,Arcticowl,30,45,65,50,70,260,FLYING,ICE
14,Kittyvile,15,25,50,30,55,175,DEMONIC,
15,Pumafiend,25,35,70,40,75,245,DEMONIC,
12,Chimilla,35,25,40,15,25,140,PLANT,NORMAL
13,Cactilla,60,40,65,25,35,225,PLANT,NORMAL
99,Mayataz,70,60,75,65,75,345,FLYING,PLANT
4,Electroboar,35,55,50,15,50,205,FIRE,ENERGY
5,Tazorback,40,65,60,20,60,245,FIRE,ENERGY
6,Sapent,25,25,35,20,35,140,PLANT,
7,Cobrapent,40,35,40,30,45,190,PLANT,
8,Quickapent,65,50,55,40,60,270,PLANT,
43,Cubble,55,35,50,10,20,170,FIRE,EARTH
44,Blazebar,80,40,70,15,20,225,FIRE,EARTH
32,Tadcoal,35,30,40,35,30,170,FIRE,
33,Volcanoad,50,32,48,40,32,202,FIRE,
34,Eruptoad,65,35,55,45,35,235,FIRE,
89,Toregg,20,25,38,5,40,128,DINO,FIRE
90,Smouldor,35,30,65,10,60,200,DINO,FIRE
91,Flamator,45,35,85,15,80,260,DINO,FIRE
38,Octaleaf,35,40,25,40,25,165,PLANT,
39,Octagrass,40,55,35,50,30,210,PLANT,
40,Octatree,45,70,45,60,35,255,PLANT,
35,Wormif,30,30,35,15,35,145,EARTH,NORMAL
36,Rottar,50,35,55,20,40,200,EARTH,NORMAL
37,Riffra,70,40,70,25,60,265,EARTH,NORMAL
101,Sobek,65,75,100,50,60,350,TITAN,
102,Seiryu,85,70,85,80,75,395,TITAN,
83,Kel'ba,25,35,60,30,35,185,UNDEAD,
84,Kel'ten,35,40,75,40,40,230,UNDEAD,
85,Kel'Tuzar,45,50,95,50,45,285,UNDEAD,
